16, 16, 16, 16, 16, 16, 16, 16, 16, 16, 16, 16, 16, 16, 16, 16, 16, 16, 16, 16, 16, 16, 16, 16, 16, 16, 16, 16, 16, 16, 16, 16, 16, 16, 16, 16, 16, 16, 16, 16, 16, 16, 16, 16, 16, 16, 16, 16, 16, 16, 16, 16, 16, 16, 16, 16, 16, 16, 16, 16,
                {16, 16, 16, 16, 16, 16, 16, 16, 16, 16, 16, 16, 16, 16, 16, 16, 16, 16, 16, 16, 16, 16, 16, 16, 16, 16, 16, 16, 16, 16, 16, 16, 16, 16, 16, 16, 16, 16, 16, 16, 16, 16, 16, 16, 16, 16, 16, 16, 16, 16, 16, 16, 16, 16, 16, 16, 16, 16, 16, 16,
                {16, 16, 16, 16, 16, 16, 16, 16, 16, 16, 16, 16, 16, 16, 16, 16, 16, 16, 16, 16, 16, 16, 16, 16, 16, 16, 16, 16, 16, 16, 16, 16, 16, 16, 16, 16, 16, 16, 16, 16, 16, 16, 16, 16, 16, 16, 16, 16, 16, 16, 16, 16, 16, 16, 16, 16, 16, 16, 16, 16,
                {16, 16, 16, 16, 16, 16, 16, 16, 16, 16, 16, 16, 16, 16, 16, 16, 16, 16, 16, 16, 16, 16, 16, 16, 16, 16, 16, 16, 16, 16, 16, 16, 16, 16, 16, 16, 16, 16, 16, 16, 16, 16, 16, 16, 16, 16, 16, 16, 16, 16, 16, 16, 16, 16, 16, 16, 16, 16, 16, 16,
                {16, 16, 16, 16, 16, 16, 16, 16, 16, 16, 16, 16, 16, 16, 16, 16, 16, 16, 16, 16, 16, 16, 16, 16, 16, 16, 16, 16, 16, 16, 16, 16, 16, 16, 16, 16, 16, 16, 16, 16, 16, 16, 16, 16, 16, 16, 16, 16, 16, 16, 16, 16, 16, 16, 16, 16, 16, 16, 16, 16,
                {16, 16, 16, 16, 16, 16, 16, 16, 16, 16, 16, 16, 16, 16, 16, 16, 16, 16, 16, 16, 16, 16, 16, 16, 16, 16, 16, 16, 16, 16, 16, 16, 16, 16, 16, 16, 16, 16, 16, 16, 16, 16, 16, 16, 16, 16, 16, 16, 16, 16, 16, 16, 16, 16, 16, 16, 16, 16, 16, 16,
                {16, 16, 16, 16, 16, 16, 16, 16, 16, 16, 16, 16, 16, 16, 16, 16, 16, 16, 16, 16, 16, 16, 16, 16, 16, 16, 16, 16, 16, 16, 16, 16, 16, 16, 16, 16, 16, 16, 16, 16, 16, 16, 16, 16, 16, 16, 16, 16, 16, 16, 16, 16, 16, 16, 16, 16, 16, 16, 16, 16,
                {16, 16, 16, 16, 16, 16, 16, 16, 16, 16, 16, 16, 16, 16, 16, 16, 16, 16, 16, 16, 16, 16, 16, 16, 16, 16, 16, 16, 16, 16, 16, 16, 16, 16, 16, 16, 16, 16, 16, 16, 16, 16, 16, 16, 16, 16, 16, 16, 16, 16, 16, 16, 16, 16, 16, 16, 16, 16, 16, 16,
                {16, 16, 16, 16, 16, 16, 16, 16, 16, 16, 16, 16, 16, 16, 16, 16, 16, 16, 16, 16, 16, 16, 16, 16, 16, 16, 16, 16, 16, 16, 16, 16, 16, 16, 16, 16, 16, 16, 16, 16, 16, 16, 16, 16, 16, 16, 16, 16, 16, 16, 16, 16, 16, 16, 16, 16, 16, 16, 16, 16,
                {16, 16, 16, 16, 16, 16, 16, 16, 16, 16, 16, 16, 16, 16, 16, 16, 16, 16, 16, 16, 16, 16, 16, 16, 16, 16, 16, 16, 16, 16, 16, 16, 16, 16, 16, 16, 16, 16, 16, 16, 16, 16, 16, 16, 16, 16, 16, 16, 16, 16, 16, 16, 16, 16, 16, 16, 16, 16, 16, 16,
                {16, 16, 16, 16, 16, 16, 16, 16, 16, 16, 16, 16, 16, 16, 16, 16, 16, 16, 16, 16, 16, 16, 16, 16, 16, 16, 16, 16, 16, 16, 16, 16, 16, 16, 16, 16, 16, 16, 16, 16, 16, 16, 16, 16, 16, 16, 16, 16, 16, 16, 16, 16, 16, 16, 16, 16, 16, 16, 16, 16,
                {16, 16, 16, 16, 16, 16, 16, 16, 16, 16, 17, 10, 10, 10, 10, 10, 10, 10, 10, 10, 10, 10, 10, 10, 10, 10, 10, 10, 10, 10, 10, 10, 10, 10, 10, 10, 10, 10, 10, 10, 10, 10, 10, 10, 10, 10, 10, 10, 10, 10, 10, 10, 10, 10, 10, 10, 10, 10, 10, 3,
                {16, 16, 16, 16, 16, 16, 16, 16, 16, 16, 14, 31, 41, 41, 41, 41, 30, 3, 3, 3, 3, 3, 3, 3, 3, 3, 3, 3, 3, 3, 3, 3, 3, 3, 3, 3, 3, 21, 3, 3, 3, 3, 3, 3, 3, 3, 3, 3, 2, 4, 4, 4, 2, 3, 3, 6, 6, 6, 6, 6,
                {16, 16, 16, 16, 16, 16, 16, 16, 16, 16, 14, 28, 43, 43, 43, 43, 43, 26, 3, 3, 3, 3, 3, 3, 3, 3, 3, 3, 3, 3, 3, 3, 3, 3, 3, 3, 3, 21, 3, 3, 3, 3, 3, 3, 3, 3, 3, 3, 2, 4, 4, 4, 2, 3, 6, 6, 6, 6, 6, 6,
                {16, 16, 16, 16, 16, 16, 16, 16, 16, 16, 14, 3, 3, 3, 3, 3, 3, 24, 22, 22, 22, 22, 22, 22, 22, 22, 22, 22, 22, 22, 22, 26, 3, 3, 3, 3, 3, 21, 3, 3, 3, 3, 3, 3, 3, 3, 3, 3, 2, 4, 4, 4, 2, 3, 6, 6, 6, 6, 6, },
                {16, 16, 16, 16, 16, 16, 16, 16, 16, 16, 14, 3, 3, 3, 3, 3, 3, 3, 3, 3, 3, 3, 3, 3, 3, 3, 3, 3, 3, 3, 3, 24, 22, 22, 22, 22, 22, 27, 3, 3, 3, 3, 3, 3, 3, 3, 3, 3, 2, 2, 4, 2, 2, 3, 6, 6, 6, 6, 6, },
                {16, 16, 16, 16, 16, 16, 16, 16, 16, 16, 14, 3, 3, 3, 3, 3, 3, 3, 3, 3, 3, 3, 3, 3, 3, 3, 3, 3, 3, 3, 3, 3, 3, 3, 3, 3, 3, 21, 3, 3, 3, 3, 3, 3, 3, 3, 3, 3, 3, 2, 4, 2, 3, 6, 6, 6, 6, 6, 6, 6,
                {16, 16, 16, 16, 16, 16, 16, 16, 16, 16, 14, 0, 0, 0, 0, 0, 0, 0, 0, 0, 0, 0, 0, 0, 0, 0, 0, 0, 0, 0, 0, 0, 0, 0, 0, 0, 0, 21, 3, 3, 3, 3, 3, 3, 3, 3, 3, 3, 3, 2, 21, 2, 3, 6, 6, 6, 6, 6, 6, 6,
                {16, 16, 16, 16, 16, 16, 16, 16, 16, 16, 14, 0, 0, 0, 0, 0, 0, 0, 0, 0, 23, 22, 22, 22, 22, 22, 22, 22, 22, 22, 22, 22, 22, 22, 22, 22, 22, 4, 3, 3, 3, 3, 3, 3, 3, 3, 3, 3, 3, 3, 21, 3, 3, 6, 6, 6, 6, 6, 6, 6,
                {16, 16, 16, 16, 16, 16, 16, 16, 16, 16, 14, 0, 22, 22, 22, 22, 22, 22, 22, 22, 25, 0, 0, 0, 0, 0, 0, 0, 0, 0, 0, 0, 0, 0, 0, 0, 0, 21, 3, 3, 3, 3, 3, 3, 3, 3, 3, 3, 3, 3, 21, 3, 3, 3, 6, 6, 6, 6, 6, 6,
                {16, 16, 16, 16, 16, 16, 16, 16, 16, 16, 14, 5, 5, 0, 0, 0, 0, 0, 0, 0, 0, 0, 0, 0, 0, 0, 0, 0, 0, 0, 0, 0, 0, 0, 0, 0, 3, 21, 3, 3, 3, 3, 3, 3, 3, 3, 3, 3, 3, 3, 21, 3, 3, 3, 3, 3, 6, 6, 6, 6,
                {16, 16, 16, 16, 16, 16, 16, 16, 16, 16, 14, 9, 7, 7, 7, 7, 7, 7, 7, 7, 7, 7, 7, 7, 7, 7, 7, 7, 7, 7, 7, 7, 7, 7, 7, 8, 3, 21, 3, 3, 3, 3, 3, 3, 3, 3, 3, 3, 3, 3, 21, 3, 3, 3, 3, 3, 6, 6, 6, 6,
                {16, 16, 16, 16, 16, 16, 16, 16, 16, 16, 14, 15, 16, 16, 16, 16, 16, 16, 16, 16, 16, 16, 16, 16, 16, 16, 16, 16, 16, 16, 16, 16, 16, 16, 16, 14, 3, 21, 3, 3, 3, 3, 3, 3, 3, 3, 3, 3, 3, 3, 21, 3, 3, 3, 3, 3, 3, 6, 6, 6,
                {16, 16, 16, 16, 16, 16, 16, 16, 16, 16, 14, 15, 16, 16, 16, 16, 16, 16, 16, 16, 16, 16, 16, 16, 16, 16, 16, 16, 16, 16, 16, 16, 16, 16, 16, 14, 3, 21, 3, 3, 3, 3, 3, 3, 3, 3, 3, 3, 3, 3, 21, 3, 3, 3, 3, 3, 3, 3, 6, 6,
                {16, 16, 16, 16, 16, 16, 16, 16, 16, 16, 14, 15, 16, 16, 16, 16, 16, 16, 16, 16, 16, 16, 16, 16, 16, 16, 16, 16, 16, 16, 16, 16, 16, 16, 16, 14, 3, 21, 3, 3, 3, 3, 3, 3, 3, 3, 3, 3, 3, 3, 21, 3, 3, 3, 3, 3, 3, 3, 3, 3,
                {16, 16, 16, 16, 16, 16, 16, 16, 16, 16, 14, 15, 16, 16, 16, 16, 16, 16, 16, 16, 16, 16, 16, 16, 16, 16, 16, 16, 16, 16, 16, 16, 16, 16, 16, 14, 3, 21, 3, 3, 3, 3, 3, 3, 3, 3, 3, 3, 3, 3, 21, 3, 3, 3, 3, 3, 3, 3, 3, 3,
                {16, 16, 16, 16, 16, 16, 16, 16, 16, 16, 14, 15, 16, 16, 16, 16, 16, 16, 16, 16, 16, 16, 16, 16, 16, 16, 16, 16, 16, 16, 16, 16, 16, 16, 16, 14, 3, 21, 3, 3, 3, 3, 3, 3, 3, 3, 3, 3, 3, 3, 21, 3, 3, 3, 3, 3, 3, 3, 3, 3,
                {16, 16, 16, 16, 16, 16, 16, 16, 16, 16, 14, 15, 16, 16, 16, 16, 16, 16, 16, 16, 16, 16, 16, 16, 17, 10, 10, 10, 10, 10, 10, 10, 10, 10, 10, 12, 3, 21, 3, 3, 3, 3, 3, 3, 3, 3, 3, 3, 3, 3, 21, 3, 3, 3, 3, 3, 3, 3, 3, 3,
                {16, 16, 16, 16, 16, 16, 16, 16, 16, 16, 14, 13, 10, 10, 10, 10, 10, 10, 10, 10, 10, 10, 10, 10, 11, 0, 0, 0, 0, 0, 0, 3, 21, 3, 0, 0, 0, 0, 0, 3, 3, 3, 3, 3, 3, 21, 3, 3, 3, 3, 21, 3, 3, 3, 3, 3, 3, 3, 3, 3,
                {16, 16, 16, 16, 16, 16, 16, 16, 16, 16, 14, 0, 0, 0, 0, 0, 0, 0, 0, 0, 0, 0, 0, 0, 0, 0, 0, 0, 0, 0, 0, 0, 0, 0, 0, 0, 3, 21, 3, 0, 0, 0, 0, 3, 3, 3, 3, 3, 3, 23, 25, 21, 3, 3, 3, 3, 3, 3, 3, 3,
                {16, 16, 16, 16, 16, 16, 16, 16, 16, 16, 14, 5, 5, 5, 5, 5, 5, 5, 5, 5, 5, 5, 5, 5, 5, 5, 5, 5, 0, 0, 0, 0, 0, 0, 0, 0, 3, 21, 3, 0, 0, 0, 3, 3, 23, 22, 22, 22, 22, 25, 3, 3, 3, 3, 3, 3, 3, 3, 3, 3,
                {16, 16, 16, 16, 16, 16, 16, 16, 16, 16, 14, 3, 3, 3, 3, 3, 3, 3, 3, 3, 3, 3, 3, 3, 3, 3, 3, 3, 3, 3, 3, 3, 3, 3, 3, 3, 3, 21, 3, 3, 3, 3, 3, 3, 21, 3, 3, 3, 3, 3, 3, 3, 3, 3, 3, 3, 3, 3, 3, 3,
                {16, 16, 16, 16, 16, 16, 16, 16, 16, 16, 14, 22, 22, 22, 22, 22, 22, 22, 22, 22, 22, 22, 22, 22, 22, 22, 22, 22, 22, 22, 22, 22, 22, 22, 22, 22, 22, 27, 22, 22, 22, 22, 22, 22, 25, 3, 3, 3, 3, 3, 3, 3, 3, 3, 3, 3, 3, 3, 3, 3,
                {16, 16, 16, 16, 16, 16, 16, 16, 16, 16, 14, 3, 3, 3, 3, 3, 3, 3, 3, 3, 3, 3, 3, 3, 3, 3, 3, 3, 3, 3, 3, 3, 3, 3, 3, 0, 0, 21, 3, 3, 3, 3, 3, 3, 3, 3, 3, 3, 3, 23, 22, 22, 22, 26, 3, 3, 3, 3, 3, 3,
                {16, 16, 16, 16, 16, 16, 16, 16, 16, 16, 14, 3, 3, 3, 3, 3, 3, 3, 3, 3, 3, 3, 3, 3, 3, 3, 3, 3, 3, 3, 3, 3, 3, 3, 3, 3, 0, 21, 3, 3, 3, 3, 3, 3, 3, 3, 23, 22, 22, 25, 3, 3, 3, 21, 3, 3, 3, 3, 3, 3,
                {16, 16, 16, 16, 16, 16, 16, 16, 16, 16, 14, 3, 3, 3, 3, 3, 3, 3, 3, 3, 3, 3, 3, 3, 3, 3, 3, 3, 3, 3, 3, 3, 3, 3, 3, 3, 0, 21, 3, 3, 3, 3, 3, 3, 3, 3, 21, 0, 9, 7, 7, 8, 0, 21, 3, 3, 3, 3, 3, 3,
                {16, 16, 16, 16, 16, 16, 16, 16, 16, 16, 14, 3, 3, 3, 3, 3, 3, 3, 3, 3, 3, 3, 3, 3, 3, 3, 3, 3, 3, 3, 3, 3, 3, 3, 3, 3, 3, 21, 3, 3, 3, 3, 3, 3, 3, 3, 21, 3, 15, 16, 16, 14, 3, 21, 3, 3, 3, 3, 3, 3,
                {16, 16, 16, 16, 16, 16, 16, 16, 16, 16, 14, 3, 3, 3, 3, 3, 3, 3, 3, 3, 3, 3, 3, 3, 3, 3, 3, 3, 3, 3, 3, 3, 3, 3, 3, 3, 3, 24, 22, 22, 22, 26, 3, 3, 3, 3, 21, 9, 20, 16, 16, 19, 8, 21, 3, 3, 3, 3, 3, 3,
                {16, 16, 16, 16, 16, 16, 16, 16, 16, 16, 14, 3, 3, 3, 3, 3, 3, 3, 3, 3, 3, 3, 3, 3, 3, 3, 3, 3, 3, 3, 3, 3, 3, 3, 3, 3, 3, 3, 3, 3, 3, 21, 3, 3, 3, 3, 21, 15, 16, 16, 16, 16, 14, 21, 3, 3, 3, 3, 3, 3,
                {16, 16, 16, 16, 16, 16, 16, 16, 16, 16, 14, 3, 3, 3, 3, 3, 3, 3, 3, 3, 3, 3, 3, 3, 3, 3, 3, 3, 3, 3, 3, 3, 3, 3, 3, 3, 3, 3, 3, 3, 3, 24, 22, 22, 22, 22, 25, 15, 16, 16, 16, 16, 14, 21, 3, 3, 3, 3, 3, 3,
                {16, 16, 16, 16, 16, 16, 16, 16, 16, 16, 14, 3, 3, 3, 3, 3, 3, 3, 3, 3, 3, 3, 3, 3, 3, 3, 3, 3, 3, 3, 3, 3, 3, 3, 3, 3, 3, 3, 3, 3, 3, 3, 3, 3, 3, 3, 3, 15, 16, 16, 16, 16, 14, 21, 3, 3, 3, 3, 3, 3,
                {16, 16, 16, 16, 16, 16, 16, 16, 16, 16, 14, 3, 3, 3, 3, 3, 3, 3, 3, 3, 3, 3, 3, 3, 3, 3, 3, 3, 3, 3, 3, 3, 3, 3, 3, 3, 3, 3, 3, 3, 3, 3, 3, 3, 3, 3, 3, 13, 10, 10, 10, 10, 11, 21, 3, 3, 3, 3, 3, 3,
                {16, 16, 16, 16, 16, 16, 16, 16, 16, 16, 14, 3, 3, 3, 3, 3, 3, 3, 3, 3, 3, 3, 3, 3, 3, 3, 3, 3, 3, 3, 3, 3, 3, 3, 3, 3, 3, 3, 3, 3, 3, 3, 3, 3, 3, 3, 3, 3, 3, 3, 3, 3, 3, 21, 3, 3, 3, 3, 3, 3,
                {16, 16, 16, 16, 16, 16, 16, 16, 16, 16, 14, 3, 3, 3, 3, 3, 3, 3, 3, 3, 3, 3, 3, 3, 3, 3, 3, 3, 3, 3, 3, 3, 3, 3, 3, 3, 3, 3, 3, 3, 3, 3, 3, 3, 3, 3, 3, 3, 3, 3, 3, 3, 3, 21, 3, 3, 3, 3, 3, 3,
                {16, 16, 16, 16, 16, 16, 16, 16, 16, 16, 14, 3, 3, 3, 3, 3, 3, 3, 3, 3, 3, 3, 3, 3, 3, 3, 3, 3, 3, 3, 3, 3, 3, 3, 3, 3, 3, 3, 3, 3, 3, 3, 3, 3, 3, 3, 3, 3, 3, 3, 3, 3, 3, 21, 3, 3, 3, 3, 3, 3,
                {16, 16, 16, 16, 16, 16, 16, 16, 16, 16, 14, 3, 3, 3, 3, 3, 3, 3, 3, 3, 3, 3, 3, 3, 3, 3, 3, 3, 3, 3, 3, 3, 3, 3, 3, 3, 3, 3, 3, 3, 3, 3, 3, 3, 3, 3, 3, 3, 3, 3, 3, 3, 3, 21, 3, 3, 3, 3, 3, 3,
                {16, 16, 16, 16, 16, 16, 16, 16, 16, 16, 14, 3, 3, 3, 3, 3, 3, 3, 3, 3, 3, 3, 3, 3, 3, 3, 3, 3, 3, 3, 3, 3, 3, 3, 3, 3, 3, 3, 3, 3, 3, 3, 3, 3, 3, 3, 3, 3, 3, 3, 3, 3, 3, 21, 3, 3, 3, 3, 3, 3,
                {16, 16, 16, 16, 16, 16, 16, 16, 16, 16, 14, 3, 3, 3, 3, 3, 3, 3, 3, 3, 3, 3, 3, 3, 3, 3, 3, 3, 3, 3, 3, 3, 3, 3, 3, 3, 3, 3, 3, 3, 3, 3, 3, 3, 3, 3, 3, 3, 3, 3, 3, 3, 3, 21, 3, 3, 3, 3, 3, 3,
                {16, 16, 16, 16, 16, 16, 16, 16, 16, 16, 14, 3, 3, 3, 3, 3, 3, 3, 3, 3, 3, 3, 3, 3, 3, 3, 3, 3, 3, 3, 3, 3, 3, 3, 3, 3, 3, 3, 3, 3, 3, 3, 3, 3, 3, 3, 3, 3, 3, 3, 3, 3, 3, 21, 3, 3, 3, 3, 3, 3,
                {16, 16, 16, 16, 16, 16, 16, 16, 16, 16, 14, 3, 3, 3, 3, 3, 3, 3, 3, 3, 3, 3, 3, 3, 3, 3, 3, 3, 3, 3, 3, 3, 3, 3, 3, 3, 3, 3, 3, 3, 3, 3, 3, 3, 3, 3, 3, 3, 3, 3, 3, 3, 3, 21, 3, 3, 3, 3, 3, 3,
                {16, 16, 16, 16, 16, 16, 16, 16, 16, 16, 14, 3, 3, 3, 3, 3, 3, 3, 3, 3, 3, 3, 3, 3, 3, 3, 3, 3, 3, 3, 3, 3, 3, 3, 3, 3, 3, 3, 3, 3, 3, 3, 3, 3, 3, 3, 3, 3, 3, 3, 3, 3, 3, 21, 3, 3, 3, 3, 3, 3,
                {16, 16, 16, 16, 16, 16, 16, 16, 16, 16, 14, 3, 3, 3, 3, 3, 3, 3, 3, 3, 3, 3, 3, 3, 3, 3, 3, 3, 3, 3, 3, 3, 3, 3, 3, 3, 3, 3, 3, 3, 3, 3, 3, 3, 3, 3, 3, 3, 3, 3, 3, 3, 3, 21, 3, 3, 3, 3, 3, 3,
                {16, 16, 16, 16, 16, 16, 16, 16, 16, 16, 14, 3, 3, 3, 3, 3, 3, 3, 3, 3, 3, 3, 3, 3, 3, 3, 3, 3, 3, 3, 3, 3, 3, 3, 3, 3, 3, 3, 3, 3, 3, 3, 3, 3, 3, 3, 3, 3, 3, 3, 3, 3, 3, 21, 3, 3, 3, 3, 3, 3,
                {16, 16, 16, 16, 16, 16, 16, 16, 16, 16, 14, 3, 3, 3, 3, 3, 3, 3, 3, 3, 3, 3, 3, 3, 3, 3, 3, 3, 3, 3, 3, 3, 3, 3, 3, 3, 3, 3, 3, 3, 3, 3, 3, 3, 3, 3, 3, 3, 3, 3, 3, 3, 3, 21, 3, 3, 3, 3, 3, 3,
                {16, 16, 16, 16, 16, 16, 16, 16, 16, 16, 14, 3, 3, 3, 3, 3, 3, 3, 3, 3, 3, 3, 3, 3, 3, 3, 3, 3, 3, 3, 3, 3, 3, 3, 3, 3, 3, 3, 3, 3, 3, 3, 3, 3, 3, 3, 3, 3, 3, 3, 3, 3, 3, 21, 3, 3, 3, 3, 3, 3,
                {16, 16, 16, 16, 16, 16, 16, 16, 16, 16, 14, 3, 3, 3, 3, 3, 3, 3, 3, 3, 3, 3, 3, 3, 3, 3, 3, 3, 3, 3, 3, 3, 3, 3, 3, 3, 3, 3, 3, 3, 3, 3, 3, 3, 3, 3, 3, 3, 3, 3, 3, 3, 3, 40, 35, 4, 4, 28, 3, 3,
                {16, 16, 16, 16, 16, 16, 16, 16, 16, 16, 14, 3, 3, 3, 3, 3, 3, 3, 3, 3, 3, 3, 3, 3, 3, 3, 3, 3, 3, 3, 3, 3, 3, 3, 3, 3, 3, 3, 3, 3, 3, 3, 3, 3, 3, 3, 3, 3, 3, 3, 3, 3, 3, 40, 39, 39, 39, 38, 3, 3,
                {16, 16, 16, 16, 16, 16, 16, 16, 16, 16, 14, 3, 3, 3, 3, 3, 3, 3, 3, 3, 3, 3, 3, 3, 3, 3, 3, 3, 3, 3, 3, 3, 3, 3, 3, 3, 3, 3, 3, 3, 3, 3, 3, 3, 3, 3, 3, 3, 3, 3, 3, 3, 3, 40, 4, 4, 4, 38, 3, 3,
                {16, 16, 16, 16, 16, 16, 16, 16, 16, 16, 14, 3, 3, 3, 3, 3, 3, 3, 3, 3, 3, 3, 3, 3, 3, 3, 3, 3, 3, 3, 3, 3, 3, 3, 3, 3, 3, 3, 3, 3, 3, 3, 3, 3, 3, 3, 3, 3, 3, 3, 3, 3, 3, 26, 4, 4, 4, 27, 3, 3,
                {16, 16, 16, 16, 16, 16, 16, 16, 16, 16, 14, 3, 3, 3, 3, 3, 3, 3, 3, 3, 3, 3, 3, 3, 3, 3, 3, 3, 3, 3, 3, 3, 3, 3, 3, 3, 3, 3, 3, 3, 3, 3, 3, 3, 3, 3, 3, 3, 3, 3, 3, 3, 3, 3, 3, 3, 3, 3, 3, 3,
                {16, 16, 16, 16, 16, 16, 16, 16, 16, 16, 19, 3, 3, 3, 3, 3, 3, 3, 3, 3, 3, 3, 3, 3, 3, 3, 3, 3, 3, 3, 3, 3, 3, 3, 3, 3, 3, 3, 3, 3, 3, 3, 3, 3, 3, 3, 3, 3, 3, 3, 3, 3, 3, 0, 0, 0, 0, 0, 0, 0,
                {16, 16, 16, 16, 16, 16, 16, 16, 16, 16, 16, 16, 16, 16, 16, 16, 16, 16, 16, 16, 16, 16, 16, 16, 16, 16, 16, 16, 16, 16, 16, 16, 16, 16, 16, 16, 16, 16, 16, 16, 16, 16, 16, 16, 16, 16, 16, 16, 16, 16, 16, 16, 16, 16, 16, 16, 16, 16, 16, 16,
                {16, 16, 16, 16, 16, 16, 16, 16, 16, 16, 16, 16, 16, 16, 16, 16, 16, 16, 16, 16, 16, 16, 16, 16, 16, 16, 16, 16, 16, 16, 16, 16, 16, 16, 16, 16, 16, 16, 16, 16, 16, 16, 16, 16, 16, 16, 16, 16, 16, 16, 16, 16, 16, 16, 16, 16, 16, 16, 16, 16,
                {16, 16, 16, 16, 16, 16, 16, 16, 16, 16, 16, 16, 16, 16, 16, 16, 16, 16, 16, 16, 16, 16, 16, 16, 16, 16, 16, 16, 16, 16, 16, 16, 16, 16, 16, 16, 16, 16, 16, 16, 16, 16, 16, 16, 16, 16, 16, 16, 16, 16, 16, 16, 16, 16, 16, 16, 16, 16, 16, 16,
                {16, 16, 16, 16, 16, 16, 16, 16, 16, 16, 16, 16, 16, 16, 16, 16, 16, 16, 16, 16, 16, 16, 16, 16, 16, 16, 16, 16, 16, 16, 16, 16, 16, 16, 16, 16, 16, 16, 16, 16, 16, 16, 16, 16, 16, 16, 16, 16, 16, 16, 16, 16, 16, 16, 16, 16, 16, 16, 16, 16,
                {16, 16, 16, 16, 16, 16, 16, 16, 16, 16, 16, 16, 16, 16, 16, 16, 16, 16, 16, 16, 16, 16, 16, 16, 16, 16, 16, 16, 16, 16, 16, 16, 16, 16, 16, 16, 16, 16, 16, 16, 16, 16, 16, 16, 16, 16, 16, 16, 16, 16, 16, 16, 16, 16, 16, 16, 16, 16, 16, 16,
                {16, 16, 16, 16, 16, 16, 16, 16, 16, 16, 16, 16, 16, 16, 16, 16, 16, 16, 16, 16, 16, 16, 16, 16, 16, 16, 16, 16, 16, 16, 16, 16, 16, 16, 16, 16, 16, 16, 16, 16, 16, 16, 16, 16, 16, 16, 16, 16, 16, 16, 16, 16, 16, 16, 16, 16, 16, 16, 16, 16,
                {16, 16, 16, 16, 16, 16, 16, 16, 16, 16, 16, 16, 16, 16, 16, 16, 16, 16, 16, 16, 16, 16, 16, 16, 16, 16, 16, 16, 16, 16, 16, 16, 16, 16, 16, 16, 16, 16, 16, 16, 16, 16, 16, 16, 16, 16, 16, 16, 16, 16, 16, 16, 16, 16, 16, 16, 16, 16, 16, 16,
                {16, 16, 16, 16, 16, 16, 16, 16, 16, 16, 16, 16, 16, 16, 16, 16, 16, 16, 16, 16, 16, 16, 16, 16, 16, 16, 16, 16, 16, 16, 16, 16, 16, 16, 16, 16, 16, 16, 16, 16, 16, 16, 16, 16, 16, 16, 16, 16, 16, 16, 16, 16, 16, 16, 16, 16, 16, 16, 16, 16,
                {16, 16, 16, 16, 16, 16, 16, 16, 16, 16, 16, 16, 16, 16, 16, 16, 16, 16, 16, 16, 16, 16, 16, 16, 16, 16, 16, 16, 16, 16, 16, 16, 16, 16, 16, 16, 16, 16, 16, 16, 16, 16, 16, 16, 16, 16, 16, 16, 16, 16, 16, 16, 16, 16, 16, 16, 16, 16, 16, 16,
                {16, 16, 16, 16, 16, 16, 16, 16, 16, 16, 16, 16, 16, 16, 16, 16, 16, 16, 16, 16, 16, 16, 16, 16, 16, 16, 16, 16, 16, 16, 16, 16, 16, 16, 16, 16, 16, 16, 16, 16, 16, 16, 16, 16, 16, 16, 16, 16, 16, 16, 16, 16, 16, 16, 16, 16, 16, 16, 16, 16